NO,NO,NO,NO,NO,NO,NO,NO,NO,NO,NO,NO,NO,NO,NO,NO,NO,NO,NO,NO,NO,NO,NO,NO,NO,NO,NO,NO,NO,NO,NO,NO,NO,NO,NO,NO,NO,NO,NO,NO,NO,NO,NO,NO,NO,NO,NO,NO,NO,NO,NO,NO,NO,NO,NO,NO,NO,NO,NO,NO,NO,NO,NO,NO,NO,NO,NO,NO,NO,NO,NO,NO,NO,NO,NO,NO,NO,NO,NO,NO
NO,NO,NO,NO,NO,NO,NO,NO,NO,NO,NO,NO,NO,NO,NO,NO,NO,NO,NO,NO,NO,NO,NO,NO,NO,NO,NO,NO,NO,NO,NO,NO,NO,NO,NO,NO,NO,NO,NO,NO,NO,NO,NO,NO,NO,NO,NO,NO,NO,NO,NO,NO,NO,NO,NO,NO,NO,NO,NO,NO,NO,NO,NO,NO,NO,NO,NO,NO,NO,NO,NO,NO,NO,NO,NO,NO,NO,NO,NO,NO
NO,NO,NO,NO,NO,NO,NO,NO,NO,NO,NO,NO,NO,NO,NO,NO,NO,NO,NO,NO,NO,NO,NO,NO,NO,NO,NO,NO,NO,NO,NO,NO,NO,NO,NO,NO,NO,NO,NO,NO,NO,NO,NO,NO,NO,NO,NO,NO,NO,NO,NO,NO,NO,NO,NO,NO,NO,NO,NO,NO,NO,NO,NO,NO,NO,NO,NO,NO,NO,NO,NO,NO,NO,NO,NO,NO,NO,NO,NO,NO
NO,NO,NO,NO,NO,NO,NO,NO,NO,NO,NO,NO,NO,NO,NO,NO,NO,NO,NO,NO,NO,NO,NB,NO,NB,NO,NO,NO,NO,NO,NO,NO,NO,NO,NO,NO,NO,NO,NO,NO,NO,NO,NO,NO,NO,NO,NO,NO,NO,NO,NO,NO,NO,NO,NO,NO,NO,NO,NO,NO,NO,NO,NO,NO,NO,NO,NO,NO,NO,NO,NO,NO,NO,NO,NO,NO,NO,NO,NO,NO
NO,NO,NO,NO,NO,NO,NO,NO,NO,NO,NO,NO,NO,NO,NO,NO,NO,NO,NO,NO,NO,NB,NB,NB,NB,NB,NO,NO,NO,NO,NO,NO,NO,NO,NO,NO,NO,NO,NO,NO,NO,NO,NO,NO,NO,NO,NO,NO,NO,NO,NO,NO,NO,NO,NO,NO,NO,NO,NO,NO,NO,NO,NO,NO,NO,NO,NO,NO,NO,NO,NO,NO,NO,NO,NO,NO,NO,NO,NO,NO
NO,NO,NO,NO,NO,NO,NO,NO,NO,NO,NO,NO,NO,NO,NO,NO,NO,NO,NO,NO,NB,NB,NB,NB,NB,NB,NB,NO,NO,NO,NO,NO,NO,NO,NO,NO,NO,NO,NO,NO,NO,NO,NO,NO,NO,NO,NO,NO,NO,NO,NO,NO,NO,NO,NO,NO,NO,NO,NO,NO,NO,NO,NO,NO,NO,NO,NO,NO,NO,NO,NO,NO,NO,NO,NO,NO,NO,NO,NO,NO
NO,NO,NO,NO,NO,NO,NO,NO,NO,NO,NO,NO,NO,NO,NO,NO,NO,NO,NO,NO,NB,NB,NB,NB,NB,NB,NB,NO,NO,NO,NO,NO,NO,NO,NO,C3,C3,NO,NO,NO,NO,NO,NO,NO,NO,NO,NO,NO,NO,NO,NO,NO,NO,NO,NO,NO,NO,NO,NO,NO,NO,NO,NO,NO,NO,NO,NO,NO,NO,NO,NO,NO,NO,NO,NO,NO,NO,NO,NO,NO
NO,NO,NO,NO,NO,NO,NO,NO,NO,NO,NO,NO,NO,NO,NO,NO,NO,NO,NO,NO,NB,NB,NO,NB,NO,NB,NB,NO,NO,NO,NO,NO,NO,NO,NO,NB,NB,NO,NO,NO,NO,NO,NO,NO,NO,NO,NO,NO,NO,NO,NO,NO,NO,NO,NO,NO,NO,NO,NO,NO,NO,NO,NO,NO,NO,NO,NO,NO,NO,NO,NO,NO,NO,NO,NO,NO,NO,NO,NO,NO
NO,NO,NO,NO,NO,NO,NO,NO,NO,NO,NO,NO,NO,NO,NO,NO,NO,NO,NO,NO,NB,NB,NO,NO,NO,NB,NB,NO,NO,NO,NO,NB,NO,NO,NO,NB,NB,NO,NO,NO,NO,NO,NO,NO,NO,NO,NO,NO,NO,NO,NO,NO,NO,NO,NO,NO,NO,NO,NO,NO,NO,NO,NO,NO,NO,NO,NO,NO,NO,NO,NO,NO,NO,NO,NO,NO,NO,NO,NO,NO
NO,NO,NO,NO,NO,NO,NO,NO,NO,NO,NO,NO,NO,NO,NO,NO,NO,NO,NO,NO,NB,NO,NB,NO,NB,NO,NB,NO,NO,NO,NO,C2,NO,NO,NO,NB,NO,NO,NO,NO,NO,NO,NO,NO,NO,NO,NO,NO,NO,NO,NO,NO,NO,NO,NO,NO,NO,NO,NO,NO,NO,NO,NO,NO,NO,NO,NO,NO,NO,NO,NO,NO,NO,NO,NO,NO,NO,NO,NO,NO
NO,NO,NO,NO,NO,NO,NO,NO,NO,NO,NO,NO,NO,NO,NO,NO,NO,NO,NO,NO,NO,NO,C1,NB,C1,NO,NO,NO,NO,NO,NO,NB,NO,NO,NO,NB,NO,NO,NO,NO,NO,NO,NO,NO,NO,NO,NO,NO,NO,NO,NO,NO,NO,NO,NO,NO,NO,NO,NO,NO,NO,NO,NO,NO,NO,NO,NO,NO,NO,NO,NO,NO,NO,NO,NO,NO,NO,NO,NO,NO
NO,NO,NO,NO,NO,NO,NO,NO,NO,NO,NO,NO,NO,NO,NO,NO,NO,NO,NO,NO,NO,C1,NB,C1,NB,C1,NO,NO,NO,NO,C2,NO,NO,NO,NO,NB,C3,NO,NO,NO,NO,NO,NO,NO,NO,NO,NO,NO,NO,NO,NO,NO,NO,NO,NO,NO,NO,NO,NO,NO,NO,NO,NO,NO,NO,NO,NO,NO,NO,NO,NO,NO,NO,NO,NO,NO,NO,NO,NO,NO
GR,GR,GR,GR,GR,GR,GR,GR,GR,GR,GR,GR,GR,GR,GR,GR,GR,GR,GR,GR,C1,NB,NB,NB,NB,NB,C1,NB,NB,C2,NB,NO,NB,NB,C3,NO,NO,NB,NB,NB,GR,GR,GR,GR,GR,GR,GR,GR,GR,GR,GR,GR,GR,GR,GR,GR,GR,GR,GR,GR,NO,NO,NO,NO,NO,NO,NO,NO,NO,NO,NO,NO,NO,NO,NO,NO,NO,NO,NO,NO
GR,GR,GR,GR,GR,GR,GR,GR,GR,GR,GR,GR,GR,GR,GR,GR,GR,GR,GR,GR,NB,NB,NB,NB,NB,NB,NB,NB,NB,NB,NB,C2,NB,NB,NB,NO,NO,NB,NB,NB,GR,GR,GR,GR,GR,GR,GR,GR,GR,GR,GR,GR,GR,GR,GR,GR,GR,GR,GR,GR,NO,NO,NO,NO,NO,NO,NO,NO,NO,NO,NO,NO,NO,NO,NO,NO,NO,NO,NO,NO
GR,GR,GR,GR,GR,GR,GR,GR,GR,GR,GR,GR,GR,GR,GR,GR,GR,GR,GR,GR,NB,NB,NB,NB,NB,NB,NB,NB,NB,NB,C2,NO,NB,NB,NB,C3,NB,NB,NB,NB,GR,GR,GR,GR,GR,GR,GR,GR,GR,GR,GR,GR,GR,GR,GR,GR,GR,GR,GR,GR,NO,NO,NO,NO,NO,NO,NO,NO,NO,NO,NO,NO,NO,NO,NO,NO,NO,NO,NO,NO
GR,GR,GR,GR,GR,GR,GR,GR,GR,GR,GR,GR,GR,GR,GR,GR,GR,GR,GR,GR,NB,NB,NO,NB,NO,NB,NB,NB,NB,NB,NB,NO,NB,NB,NB,NB,NB,NB,NB,NB,GR,GR,GR,GR,GR,GR,GR,GR,GR,GR,GR,GR,GR,GR,GR,GR,GR,GR,GR,GR,NO,NO,NO,NO,NO,NO,NO,NO,NO,NO,NO,NO,NO,NO,NO,NO,NO,NO,NO,NO
GR,GR,GR,GR,GR,GR,GR,GR,GR,GR,GR,GR,GR,GR,GR,GR,GR,GR,GR,GR,NB,NO,NO,NO,NO,NO,NB,NB,NB,NB,NB,NO,NB,NB,NB,NB,NB,NB,NB,NB,GR,GR,GR,GR,GR,GR,GR,GR,GR,GR,GR,GR,GR,GR,GR,GR,GR,GR,GR,GR,NO,NO,NO,NO,NO,NO,NO,NO,NO,NO,NO,NO,NO,NO,NO,NO,NO,NO,NO,NO
GR,GR,GR,GR,GR,GR,GR,GR,GR,GR,GR,GR,GR,GR,GR,GR,GR,GR,GR,GR,NO,NO,NO,NO,NO,NO,NO,NO,NO,NO,NO,NO,NO,NO,NO,NO,NO,NO,NO,NO,GR,GR,GR,GR,GR,GR,GR,GR,GR,GR,GR,GR,GR,GR,GR,GR,GR,GR,GR,GR,NO,NO,NO,NO,NO,NO,NO,NO,NO,NO,NO,NO,NO,NO,NO,NO,NO,NO,NO,NO
GR,GR,GR,GR,GR,GR,GR,GR,GR,GR,GR,GR,GR,GR,GR,GR,GR,GR,GR,GR,NO,NO,NO,NO,NO,NO,NO,NO,NO,NO,NO,NO,NO,NO,NO,NO,NO,NO,NO,NO,GR,GR,GR,GR,GR,GR,GR,GR,GR,GR,GR,GR,GR,GR,GR,GR,GR,GR,GR,GR,NO,NO,NO,NO,NO,NO,NO,NO,NO,NO,NO,NO,NO,NO,NO,NO,NO,NO,NO,NO
GR,GR,GR,GR,GR,GR,GR,GR,GR,GR,GR,GR,GR,GR,GR,GR,GR,GR,GR,GR,NO,NO,NO,NO,NO,NO,NO,NO,NO,NO,NO,NO,NO,NO,NO,NO,NO,NO,NO,NO,GR,GR,GR,GR,GR,GR,GR,GR,GR,GR,GR,GR,GR,GR,GR,GR,GR,GR,GR,GR,NO,NO,NO,NO,NO,NO,NO,NO,NO,NO,NO,NO,NO,NO,NO,NO,NO,NO,NO,NO
