NO,NO,NO,NO,NO,NO,NO,NO,NO,NO,NO,NO,NO,NO,NO,NO,NO,NO,NO,NO,NO,NO,NO,NO,NO,NO,NO,NO,NO,NO,NO,NO,NO,NO,NO,NO,NO,NO,NO,NO,NO,NO,NO,NO,NO,NO,NO,NO,NO,NO,NO,NO,NO,NO,NO,NO,NO,NO,NO,NO,NO,NO,NB,NB,NB,NO,NO,NO,NO,NO,NO,NO,NO,NO,NO,NO,NO,NO,NO,NO,NO,NO,NO,NO,NO,NO,NO,NO,NO,NO
NO,NO,NO,NO,NO,NO,NO,NO,NO,NO,NO,NO,NO,NO,NO,NO,NO,NO,NO,NO,NO,NO,NO,NO,NO,NO,NO,NO,NO,NO,NO,NO,NO,NO,NO,NO,NO,NO,NO,NO,NO,NO,NO,NO,NO,NO,NO,NO,NO,NO,NO,NO,NO,NO,NO,NO,NO,NO,NO,NO,NO,NO,NB,NB,NB,NO,NO,NO,NO,NO,NO,NO,NO,NO,NO,NO,NO,NO,NO,NO,NO,NO,NO,NO,NO,NO,NO,NO,NO,NO
NO,NO,NO,NO,NO,NO,NO,NO,NO,NO,NO,NO,NO,NO,NO,NO,NO,NO,NO,NO,NO,NO,NO,NO,NO,NO,NO,NO,NO,NO,NO,NO,NO,NO,NO,NO,NO,NO,NO,NO,NO,NO,NO,NO,NO,NO,NO,NO,NO,NO,NO,NO,NO,NO,NO,NO,NO,NO,NO,NO,NO,NO,NB,NB,NB,NO,NO,NO,NO,NO,NO,NO,NO,NO,NO,NO,NO,NO,NO,NO,NO,NO,NO,NO,NO,NO,NO,NO,NO,NO
NO,NO,NO,NO,NO,NO,NO,NO,NO,NO,NO,NO,NO,NO,NO,NO,NO,NO,NO,NO,NO,NO,NO,NO,NO,NO,NO,NO,NO,NO,NO,NO,NO,NO,NO,NO,NO,NO,NO,NO,NO,NO,C3,C3,NB,NB,NB,NB,NB,NB,NB,NB,NB,NB,NB,NB,NB,NB,NB,NB,NB,NB,NB,NB,NB,NO,NO,NO,NO,NO,NO,NO,NO,NO,NO,NO,NO,NO,NO,NO,NO,NO,NO,NO,NO,NO,NO,NO,NO,NO
NO,NO,NO,NO,NO,NO,NO,NO,NO,NO,NO,NO,NO,NO,NO,NO,NO,NO,NO,NO,NO,NO,NO,NO,NO,NO,NO,NO,NO,NO,NO,NO,NO,NO,NO,NB,NB,NO,NO,NO,NO,NO,NB,NB,NB,NB,NB,NB,NB,NB,NB,NB,C3,C3,NB,NB,NB,NB,NB,NB,NB,NB,NB,NB,NB,NO,NO,NO,NO,NO,NO,NO,NO,NO,NO,NO,NO,NO,NO,NO,NO,NO,NO,NO,NO,NO,NO,NO,NO,NO
NO,NO,NO,NO,NO,NO,NO,NO,NO,NO,NO,NO,NO,NO,NO,NO,NO,NO,NO,NO,NO,NO,NO,NO,NO,NO,NO,NO,NO,NO,NO,NO,NO,NO,NO,NB,NB,NO,NO,NO,NO,NO,NB,NB,C3,C3,NB,NB,NB,NB,NB,NB,NB,NB,C3,C3,NB,NB,NB,NB,NB,NB,NB,NB,NB,NO,NO,NO,NO,NO,NO,NO,NO,NO,NO,NO,NO,NO,NO,NO,NO,NO,NO,NO,NO,NO,NO,NO,NO,NO
NO,NO,NO,NO,NO,NO,NO,NO,NO,NO,NO,NO,NO,NO,NO,NO,NO,NO,NO,NO,NO,NO,NO,NO,NO,NO,NO,NO,NO,NO,NO,NO,NO,NO,NB,NB,NB,NB,NO,NO,NO,NO,NO,NO,NO,NO,NO,NO,NO,NO,NO,NO,NO,NO,NO,NO,NB,NB,NO,NO,NB,NB,NB,NB,NB,NO,NO,NO,NO,NO,NO,NO,NO,NO,NO,NO,NO,NO,NO,NO,NO,NO,NO,NO,NO,NO,NO,NO,NO,NO
NO,NO,NO,NO,NO,NO,NO,NO,NO,NO,NO,NO,NO,NO,NO,NO,NO,NO,NO,NO,NO,NO,NO,NO,NO,NO,NO,NO,NO,NO,NO,NO,NO,NO,NB,NO,NO,NB,NO,NO,NO,NO,NO,NO,NO,NO,NO,NO,NO,NO,NO,NO,NO,NO,NO,NO,NB,NB,NO,NO,NB,NB,NB,NB,NB,NO,NO,NO,NO,NO,NO,NO,NO,NO,NO,NO,NO,NO,NO,NO,NO,NO,NO,NO,NO,NO,NO,NO,NO,NO
NO,NO,NO,NO,NO,NO,NO,NO,NO,NO,NO,NO,NO,NO,NO,NO,NO,NO,NO,NO,NO,NO,NO,NO,NO,NO,NO,NO,NO,NO,NO,NO,NO,NO,NB,NO,NO,NB,NO,NO,NO,NO,NO,NO,NO,NO,NO,NO,NO,NO,NO,NO,NO,NO,NO,NO,NB,NB,NO,NO,NB,NB,NB,NB,NB,NO,NO,NO,NO,NO,NO,NO,NO,NO,NO,NO,NO,NO,NO,NO,NO,NO,NO,NO,NO,NO,NO,NO,NO,NO
NO,NO,NO,NO,NO,NO,NO,NO,NO,NO,NO,NO,NO,NO,NO,NO,NO,NO,NO,NO,NO,NO,NO,NO,NO,NO,NO,NO,NO,NO,NO,NO,NO,NO,NO,NO,NO,NO,NO,NO,NO,NO,NB,NB,NB,NB,C3,C3,NB,NB,NO,NO,NB,NB,NB,NB,NB,NB,NO,NO,NO,NO,NO,NO,NO,NO,NO,NO,NO,NO,NO,NO,NO,NO,NO,NO,NO,NO,NO,NO,NO,NO,NO,NO,NO,NO,NO,NO,NO,NO
NO,NO,NO,NO,NO,NO,NO,NO,NO,NO,NO,NO,NO,NO,NO,NO,NO,NO,NO,NO,NO,NO,NO,NO,NO,NO,NO,NO,NO,NO,NO,NO,NO,NO,NO,NB,NB,NO,NO,NO,NO,NO,NB,NB,NB,NB,NB,NB,NB,NB,NO,NO,NB,NB,NB,NB,NB,NB,NO,NO,NO,NO,NO,NO,NO,NO,NO,NO,NO,NO,NO,NO,NO,NO,NO,NO,NO,NO,NO,NO,NO,NO,NO,NO,NO,NO,NO,NO,NO,NO
NO,NO,NO,NO,NO,NO,NO,NO,NO,NO,NO,NO,NO,NO,NO,NO,NO,NO,NO,NO,NO,NO,NO,NO,NO,NO,NO,NO,NO,NO,NO,NO,NO,NO,NO,NB,NB,NO,NO,NO,NO,NO,NB,NB,NB,NB,NB,NB,NO,NO,C3,C3,NO,NO,NO,NO,NO,NO,NO,NO,NO,NO,NO,NO,NO,NO,NO,NO,NO,NO,NO,NO,NO,NO,NO,NO,NO,NO,NO,NO,NO,NO,NO,NO,NO,NO,NO,NO,NO,NO
GR,GR,GR,GR,GR,GR,GR,GR,GR,GR,GR,GR,GR,GR,GR,GR,GR,GR,GR,GR,GR,GR,GR,GR,GR,NB,NB,NB,NO,NO,NO,NO,NO,NO,NB,C2,C2,NB,NO,NO,NO,NO,NB,NB,NB,NB,NB,NB,NO,NO,NO,NO,NO,NO,NO,NO,NO,NO,NO,NO,C1,C1,NB,NB,NB,GR,GR,GR,GR,GR,GR,GR,GR,GR,GR,GR,GR,GR,GR,GR,GR,GR,GR,GR,GR,GR,GR,GR,GR,GR
GR,GR,GR,GR,GR,GR,GR,GR,GR,GR,GR,GR,GR,GR,GR,GR,GR,GR,GR,GR,GR,GR,GR,GR,GR,NB,NB,NB,NB,NB,NB,NO,NO,NO,C2,NO,NO,C2,NO,NO,NO,NO,NB,NB,NB,NB,NB,NB,NO,NO,NO,NO,NO,NO,NO,NO,NO,NO,NO,NO,NB,NB,NO,NO,NO,GR,GR,GR,GR,GR,GR,GR,GR,GR,GR,GR,GR,GR,GR,GR,GR,GR,GR,GR,GR,GR,GR,GR,GR,GR
GR,GR,GR,GR,GR,GR,GR,GR,GR,GR,GR,GR,GR,GR,GR,GR,GR,GR,GR,GR,GR,GR,GR,GR,GR,NB,NB,NB,NB,NB,NB,NB,NB,C2,NO,NO,NO,NO,C2,NB,NB,C3,NB,NB,NB,NB,NB,NB,C3,C3,NB,NB,NB,NB,NB,NB,NB,NB,C1,C1,NO,NO,NO,NO,NO,GR,GR,GR,GR,GR,GR,GR,GR,GR,GR,GR,GR,GR,GR,GR,GR,GR,GR,GR,GR,GR,GR,GR,GR,GR
GR,GR,GR,GR,GR,GR,GR,GR,GR,GR,GR,GR,GR,GR,GR,GR,GR,GR,GR,GR,GR,GR,GR,GR,GR,NO,NO,NO,NB,NB,NB,NB,NB,NB,NO,NO,NO,NO,NO,NB,NB,NB,NO,NO,NO,NO,NO,NO,NO,NO,NO,NO,NO,NO,NO,NO,NO,NO,NB,NB,NO,NO,NO,NO,NO,GR,GR,GR,GR,GR,GR,GR,GR,GR,GR,GR,GR,GR,GR,GR,GR,GR,GR,GR,GR,GR,GR,GR,GR,GR
GR,GR,GR,GR,GR,GR,GR,GR,GR,GR,GR,GR,GR,GR,GR,GR,GR,GR,GR,GR,GR,GR,GR,GR,GR,NO,NO,NO,NO,NO,NO,NB,NB,NB,NO,NO,NO,NO,NO,NB,NB,NB,NO,NO,NO,NO,NO,NO,NO,NO,NO,NO,NO,NO,NO,NO,NO,NO,NB,NB,NO,NO,NO,NO,NO,GR,GR,GR,GR,GR,GR,GR,GR,GR,GR,GR,GR,GR,GR,GR,GR,GR,GR,GR,GR,GR,GR,GR,GR,GR
GR,GR,GR,GR,GR,GR,GR,GR,GR,GR,GR,GR,GR,GR,GR,GR,GR,GR,GR,GR,GR,GR,GR,GR,GR,NO,NO,NO,NO,NO,NO,NO,NO,NO,NO,NO,NO,NO,NO,NO,NO,NO,NO,NO,NO,NO,NO,NO,NO,NO,NO,NO,NO,NO,NO,NO,NO,NO,NB,NB,NO,NO,NO,NO,NO,GR,GR,GR,GR,GR,GR,GR,GR,GR,GR,GR,GR,GR,GR,GR,GR,GR,GR,GR,GR,GR,GR,GR,GR,GR
GR,GR,GR,GR,GR,GR,GR,GR,GR,GR,GR,GR,GR,GR,GR,GR,GR,GR,GR,GR,GR,GR,GR,GR,GR,NO,NO,NO,NO,NO,NO,NO,NO,NO,NO,NO,NO,NO,NO,NO,NO,NO,NO,NO,NO,NO,NO,NO,NO,NO,NO,NO,NO,NO,NO,NO,NO,NO,NB,NB,NO,NO,NO,NO,NO,GR,GR,GR,GR,GR,GR,GR,GR,GR,GR,GR,GR,GR,GR,GR,GR,GR,GR,GR,GR,GR,GR,GR,GR,GR
GR,GR,GR,GR,GR,GR,GR,GR,GR,GR,GR,GR,GR,GR,GR,GR,GR,GR,GR,GR,GR,GR,GR,GR,GR,NO,NO,NO,NO,NO,NO,NO,NO,NO,NO,NO,NO,NO,NO,NO,NO,NO,NO,NO,NO,NO,NO,NO,NO,NO,NO,NO,NO,NO,NO,NO,NO,NO,NB,NB,NO,NO,NO,NO,NO,GR,GR,GR,GR,GR,GR,GR,GR,GR,GR,GR,GR,GR,GR,GR,GR,GR,GR,GR,GR,GR,GR,GR,GR,GR
