NO,NO,NO,NO,NO,NO,NO,NO,NO,NO,NO,NO,NO,NO,NO,NO,NO,NO,NO,NO,NO,NO,NO,NO,NO,NO,NO,NO,NO,NO,NO,NB,NB,NB,NB,NO,NO,NO,NO,NO,NO,NO,NO,NO,NO,NO,NO,NO,NO,NO,NO,NO,NO,NO,NO,NO,NO,NO,NO,NO,NO,NO,NB,NB,NB,NO,NO,NO,NO,NO,NO,NO,NO,NO,NO,NO,NO,NO,NO,NO,NO,NO,NO,NO,NO,NO,NO,NO,NO,NO
NO,NO,NO,NO,NO,NO,NO,NO,NO,NO,NO,NO,NO,NO,NO,NO,NO,NO,NO,NO,NO,NO,NO,NO,NO,NO,NO,NO,NO,NO,NO,NB,NB,NB,NB,NO,NO,NO,NO,NO,NO,NO,NO,NO,NO,NO,NO,NO,NO,NO,NO,NO,NO,NO,NO,NO,NO,NO,NO,NO,NO,NO,NB,NB,NB,NO,NO,NO,NO,NO,NO,NO,NO,NO,NO,NO,NO,NO,NO,NO,NO,NO,NO,NO,NO,NO,NO,NO,NO,NO
NO,NO,NO,NO,NO,NO,NO,NO,NO,NO,NO,NO,NO,NO,NO,NO,NO,NO,NO,NO,NO,NO,NO,NO,NO,NO,NO,NO,NO,NO,NO,NB,NB,NB,NB,NO,NO,NO,NO,NO,NO,NO,NO,NO,NO,NO,NO,NO,NO,NO,NO,NO,NO,NO,NO,NO,NO,NO,NB,NB,NB,NO,NB,NB,NB,NO,NO,NO,NO,NO,NO,NO,NO,NO,NO,NO,NO,NO,NO,NO,NO,NO,NO,NO,NO,NO,NO,NO,NO,NO
NO,NO,NO,NO,NO,NO,NO,NO,NO,NO,NO,NO,NO,NO,NO,NO,NO,NO,NO,NO,NO,NO,NO,NO,NO,NO,NO,NO,NO,NO,NO,NB,NB,NB,NB,NO,NO,NO,NO,NO,NO,NO,C3,C3,NB,NB,NB,NB,NO,NO,NB,NB,NB,NB,NB,NB,NB,NB,NB,NB,NB,LC2,NB,NB,NB,NO,NO,NO,NO,NO,NO,NO,NO,NO,NO,NO,NO,NO,NO,NO,NO,NO,NO,NO,NO,NO,NO,NO,NO,NO
NO,NO,NO,NO,NO,NO,NO,NO,NO,NO,NO,NO,NO,NO,NO,NO,NO,NO,NO,NO,NO,NO,NO,NO,NO,NO,NO,NO,NO,NO,NO,NB,NB,NB,NB,NO,NO,NO,NO,NO,NO,NO,NB,NB,NB,NB,NB,NB,NO,NO,NB,NB,C3,C3,NB,NB,NB,NB,NO,NO,ST,NB,NB,NB,NB,NO,NO,NO,NO,NO,NO,NO,NO,NO,NO,NO,NO,NO,NO,NO,NO,NO,NO,NO,NO,NO,NO,NO,NO,NO
NO,NO,NO,NO,NO,NO,NO,NO,NO,NO,NO,NO,NO,NO,NO,NO,NO,NO,NO,NO,NO,NO,NO,NO,NO,NO,NO,NO,NO,NO,NO,NB,NB,NB,NB,NO,NO,NO,NO,NO,NO,NO,NB,NB,C3,C3,NB,NB,NO,NO,NB,NB,NB,NB,C3,C3,NB,NB,C2,C2,C2,NB,NB,NB,NB,NO,NO,NO,NO,NO,NO,NO,NO,NO,NO,NO,NO,NO,NO,NO,NO,NO,NO,NO,NO,NO,NO,NO,NO,NO
NO,NO,NO,NO,NO,NO,NO,NO,NO,NO,NO,NO,NO,NO,NO,NO,NO,NO,NO,NO,NO,NO,NO,NO,NO,NO,NO,NO,NO,NO,NO,NB,NB,NB,NB,NO,NO,NO,NO,NO,NO,NO,NO,NO,NO,NO,NO,NO,NO,NO,NO,NO,NO,NO,NO,NO,NB,NB,NO,NO,NO,NO,NO,NO,NO,NO,NO,NO,NO,NO,NO,NO,NO,NO,NO,NO,NO,NO,NO,NO,NO,NO,NO,NO,NO,NO,NO,NO,NO,NO
NO,NO,NO,NO,NO,NO,NO,NO,NO,NO,NO,NO,NO,NO,NO,NO,NO,NO,NO,NO,NO,NO,NO,NO,NO,NO,NO,NO,NB,NB,LC2,NO,NO,NO,NO,NO,NO,NO,NO,NO,NO,NO,NO,NO,NO,NO,NO,NO,NO,NO,NO,NO,NO,NO,NO,NO,NB,NB,NO,NO,NO,NO,NO,NO,NO,NO,NO,NO,NO,NO,NO,NO,NO,NO,NO,NO,NO,NO,NO,NO,NO,NO,NO,NO,NO,NO,NO,NO,NO,NO
NO,NO,NO,NO,NO,NO,NO,NO,NO,NO,NO,NO,NO,NO,NO,NO,NO,NO,NO,NO,NO,NO,NO,NO,NO,NO,NO,NO,NB,NB,NB,NO,NO,NO,NO,NO,NO,NO,NO,NO,NO,NO,NO,NO,NO,NO,NO,NO,NO,NO,NO,NO,NO,NO,NO,NO,NB,NB,NO,NO,NO,NO,NO,NO,NO,NO,NO,NO,NO,NO,NO,NO,NO,NO,NO,NO,NO,NO,NO,NO,NO,NO,NO,NO,NO,NO,NO,NO,NO,NO
NO,NO,NO,NO,NO,NO,NO,NO,NO,NO,NO,NO,NO,NO,NO,NO,NO,NO,NO,NO,NO,NO,NO,NO,NO,NO,NO,NO,NB,NB,NB,NO,NO,NO,NO,NO,NO,NO,NO,NO,LC3,LC3,NB,NB,NB,NB,LC3,LC3,NB,NB,NO,NO,NB,NB,NB,NB,NB,NB,NO,NO,NO,NO,NO,NO,NO,NO,NO,NO,NO,NO,NO,NO,NO,NO,NO,NO,NO,NO,NO,NO,NO,NO,NO,NO,NO,NO,NO,NO,NO,NO
NO,NO,NO,NO,NO,NO,NO,NO,NO,NO,NO,NO,NO,NO,NO,NO,NO,NO,NO,NO,NO,NO,NO,NO,NO,LC4,LC1,LC4,NO,NO,NO,NO,NO,NO,NO,NO,NO,NO,NO,NO,NB,NB,NB,NB,NB,NB,NB,NB,NB,NB,NO,NO,NB,NB,NB,NB,NB,NB,NO,NO,NB,NB,NB,NB,NB,NO,NO,NO,NO,NO,NO,NO,NO,NO,NO,NO,NO,NO,NO,NO,NO,NO,NO,NO,NO,NO,NO,NO,NO,NO
NO,NO,NO,NO,NO,NO,NO,NO,NO,NO,NO,NO,NO,NO,NO,NO,NO,NO,NO,NO,NO,NO,NO,NO,NO,LC1,LC4,LC1,NO,NO,NO,NO,NO,NO,NO,NO,NO,NO,NO,NO,NB,NB,NB,NB,NB,NB,NB,NB,NB,NB,C3,C3,NB,NB,NB,NB,NB,NB,NO,NO,NB,NB,NB,NB,NB,NO,NO,NO,NO,NO,NO,NO,NO,NO,NO,NO,NO,NO,NO,NO,NO,NO,NO,NO,NO,NO,NO,NO,NO,NO
GR,GR,GR,GR,GR,GR,GR,GR,GR,GR,GR,GR,GR,GR,GR,GR,GR,GR,GR,GR,GR,GR,GR,GR,GR,NO,NO,NO,NO,NO,NO,NO,NO,NO,NO,NO,NO,NO,NB,NB,NB,NB,NB,NB,NB,NB,NB,NB,NO,NO,NO,NO,NO,NO,NO,NO,NO,NO,NO,NO,C1,C1,C1,NB,NB,GR,GR,GR,GR,GR,GR,GR,GR,GR,GR,GR,GR,GR,GR,GR,GR,GR,GR,GR,GR,GR,GR,GR,GR,GR
GR,GR,GR,GR,GR,GR,GR,GR,GR,GR,GR,GR,GR,GR,GR,GR,GR,GR,GR,GR,GR,GR,GR,GR,GR,NO,NO,NO,NO,NO,NO,NO,NO,NO,NO,NO,NO,NO,NB,NB,NB,NB,NB,NB,NB,NB,NB,NB,NO,NO,NO,NO,NO,NO,NO,NO,NO,NO,NO,NO,NB,NB,NB,NB,NB,GR,GR,GR,GR,GR,GR,GR,GR,GR,GR,GR,GR,GR,GR,GR,GR,GR,GR,GR,GR,GR,GR,GR,GR,GR
GR,GR,GR,GR,GR,GR,GR,GR,GR,GR,GR,GR,GR,GR,GR,GR,GR,GR,GR,GR,GR,GR,GR,GR,GR,NO,NO,NO,C2,C2,NB,NO,NO,NO,NO,LC3,LC3,LC3,NO,NO,NB,NB,NB,NB,NB,NB,NB,NB,NO,NO,NO,NO,NO,NO,NO,NO,NO,NO,NO,NO,NB,NB,NB,C1,C1,GR,GR,GR,GR,GR,GR,GR,GR,GR,GR,GR,GR,GR,GR,GR,GR,GR,GR,GR,GR,GR,GR,GR,GR,GR
GR,GR,GR,GR,GR,GR,GR,GR,GR,GR,GR,GR,GR,GR,GR,GR,GR,GR,GR,GR,GR,GR,GR,GR,GR,NO,ST,NO,NB,NB,NB,NO,NB,NB,NO,NB,NB,NB,NO,ST,NB,NB,NB,NB,NB,NB,NB,NB,C3,C3,NB,NB,NB,NB,NB,NB,NB,NB,LC1,LC1,NB,NB,NB,NB,NB,GR,GR,GR,GR,GR,GR,GR,GR,GR,GR,GR,GR,GR,GR,GR,GR,GR,GR,GR,GR,GR,GR,GR,GR,GR
GR,GR,GR,GR,GR,GR,GR,GR,GR,GR,GR,GR,GR,GR,GR,GR,GR,GR,GR,GR,GR,GR,GR,GR,GR,NB,NB,NB,NB,NB,NB,NO,NB,NB,NO,NB,NB,NB,C3,C3,NB,NB,NB,NB,NB,NB,NB,NB,NB,NB,NB,NB,NB,NB,NB,NB,NB,NB,NB,NB,NB,NB,NB,NB,NB,GR,GR,GR,GR,GR,GR,GR,GR,GR,GR,GR,GR,GR,GR,GR,GR,GR,GR,GR,GR,GR,GR,GR,GR,GR
GR,GR,GR,GR,GR,GR,GR,GR,GR,GR,GR,GR,GR,GR,GR,GR,GR,GR,GR,GR,GR,GR,GR,GR,GR,NB,NB,NB,NB,NB,NB,NO,NB,NB,NO,NB,NB,NB,NB,NB,NB,NB,NB,NB,NB,NB,NB,NB,NB,NB,NB,NB,NB,NB,NB,NB,NB,NB,NB,NB,NB,NB,NB,NB,NB,GR,GR,GR,GR,GR,GR,GR,GR,GR,GR,GR,GR,GR,GR,GR,GR,GR,GR,GR,GR,GR,GR,GR,GR,GR
GR,GR,GR,GR,GR,GR,GR,GR,GR,GR,GR,GR,GR,GR,GR,GR,GR,GR,GR,GR,GR,GR,GR,GR,GR,NB,NB,NB,NB,NB,NB,NO,NB,NB,NO,NB,NB,NB,NB,NB,NB,NB,NB,NB,NB,NB,NB,NB,NB,NB,NB,NB,NB,NB,NB,NB,NB,NB,NB,NB,NB,NB,NB,NB,NB,GR,GR,GR,GR,GR,GR,GR,GR,GR,GR,GR,GR,GR,GR,GR,GR,GR,GR,GR,GR,GR,GR,GR,GR,GR
GR,GR,GR,GR,GR,GR,GR,GR,GR,GR,GR,GR,GR,GR,GR,GR,GR,GR,GR,GR,GR,GR,GR,GR,GR,NB,NB,NB,NB,NB,NB,NO,NB,NB,NO,NB,NB,NB,NB,NB,NB,NB,NB,NB,NB,NB,NB,NB,NB,NB,NB,NB,NB,NB,NB,NB,NB,NB,NB,NB,NB,NB,NB,NB,NB,GR,GR,GR,GR,GR,GR,GR,GR,GR,GR,GR,GR,GR,GR,GR,GR,GR,GR,GR,GR,GR,GR,GR,GR,GR
